true_label,pred_0,pred_1,pred_2,pred_3,pred_4,pred_5,pred_6,pred_7,pred_8,pred_9,pred_10,pred_11
0,0,0,0,0,0,0,0,0,0,0,0,0
1,2,242,0,3,0,5,2,0,0,0,0,2
2,1,2,198,4,11,4,1,2,1,0,17,11
3,1,0,0,254,0,3,0,0,7,5,1,1
4,0,2,1,3,229,0,0,4,2,2,7,3
5,2,21,2,5,0,226,1,0,2,1,0,7
6,2,1,2,2,1,4,228,0,0,0,2,17
7,2,0,0,1,1,1,0,228,6,0,1,6
8,2,2,0,25,0,2,0,8,214,0,0,9
9,1,1,0,4,0,0,0,0,0,242,0,1
10,3,1,5,3,13,0,5,1,2,0,208,10
11,1,2,10,5,3,5,9,5,0,8,5,203
