true_label,pred_0,pred_1,pred_2,pred_3,pred_4,pred_5,pred_6,pred_7,pred_8,pred_9,pred_10,pred_11
0,0,0,0,0,0,0,0,0,0,0,0,0
1,0,230,1,2,0,11,2,0,0,0,0,10
2,0,2,231,2,0,8,2,0,1,0,1,5
3,0,0,0,251,0,2,1,0,9,0,5,4
4,0,0,39,1,181,3,3,1,1,0,18,6
5,1,4,3,1,0,252,5,0,0,0,0,1
6,0,0,0,3,0,3,234,3,1,0,1,14
7,0,0,2,2,2,0,2,216,11,0,1,10
8,0,0,0,36,0,2,3,8,208,1,1,3
9,0,0,0,5,0,0,1,0,1,236,3,3
10,0,0,30,7,3,3,3,0,0,2,196,7
11,0,1,16,5,2,7,7,6,3,6,10,193
