true_label,pred_0,pred_1,pred_2,pred_3,pred_4,pred_5,pred_6,pred_7,pred_8,pred_9,pred_10,pred_11
0,0,0,0,0,0,0,0,0,0,0,0,0
1,0,222,2,0,2,16,1,2,3,0,1,7
2,0,2,206,3,4,7,2,4,2,0,15,7
3,0,0,2,249,0,0,1,4,10,1,3,2
4,0,1,5,0,223,1,0,7,1,2,9,4
5,0,4,4,5,0,239,2,1,4,3,0,5
6,0,0,1,1,1,5,230,5,0,0,2,14
7,0,0,0,0,2,1,1,227,9,1,0,5
8,0,0,1,14,0,3,0,7,231,1,0,5
9,0,1,0,7,0,0,0,2,1,237,1,0
10,0,0,7,4,9,2,1,5,1,3,212,7
11,0,0,8,4,10,2,11,8,6,2,11,194
