true_label,pred_0,pred_1,pred_2,pred_3,pred_4,pred_5,pred_6,pred_7,pred_8,pred_9,pred_10,pred_11
0,0,0,0,0,0,0,0,0,0,0,0,0
1,2,236,1,0,0,5,4,1,4,0,0,3
2,0,1,216,2,3,6,6,1,0,2,8,7
3,0,0,0,239,0,1,3,0,15,6,4,4
4,1,1,5,1,221,0,3,6,0,0,11,4
5,1,15,4,3,0,232,6,1,1,2,1,1
6,0,0,1,0,0,2,234,3,2,1,4,12
7,0,0,1,1,5,0,1,225,8,1,1,3
8,0,0,1,15,0,2,5,7,226,2,0,4
9,0,0,0,1,3,0,1,1,2,240,0,1
10,0,1,16,1,12,1,3,2,1,2,207,5
11,0,0,6,2,13,6,9,13,5,8,10,184
