true_label,pred_0,pred_1,pred_2,pred_3,pred_4,pred_5,pred_6,pred_7,pred_8,pred_9,pred_10,pred_11
0,0,0,0,0,0,0,0,0,0,0,0,0
1,0,240,0,1,2,4,1,0,0,0,0,8
2,1,3,230,1,2,1,0,0,0,1,7,6
3,0,0,0,245,1,3,0,2,4,1,4,12
4,0,0,16,2,216,1,1,1,0,0,11,5
5,0,10,3,4,0,241,4,0,0,0,0,5
6,0,0,0,2,1,4,236,0,1,0,0,15
7,0,0,1,3,0,1,0,230,2,0,0,9
8,0,0,1,10,0,1,1,6,236,2,3,2
9,0,0,0,3,1,1,0,0,1,230,7,6
10,1,0,15,6,3,3,2,1,3,1,206,10
11,0,2,4,4,12,4,8,6,1,2,8,205
