true_label,pred_0,pred_1,pred_2,pred_3,pred_4,pred_5,pred_6,pred_7,pred_8,pred_9,pred_10,pred_11
0,0,0,0,0,0,0,0,0,0,0,0,0
1,0,244,1,0,1,1,2,0,0,0,1,6
2,0,3,226,2,3,3,2,0,0,2,7,4
3,0,0,2,252,0,1,0,2,7,1,2,5
4,0,0,18,0,218,1,1,1,0,0,7,7
5,0,6,2,0,0,246,8,0,0,1,1,3
6,0,0,1,1,0,3,241,0,1,1,2,9
7,0,1,1,1,1,1,0,228,7,0,1,5
8,0,0,3,16,0,4,0,9,225,1,0,4
9,0,0,1,5,2,0,1,0,1,235,1,3
10,0,1,7,12,11,2,0,0,0,4,207,7
11,0,0,7,4,6,8,6,6,7,2,8,202
